{
    "name": "Stage 02",
    "grid": [
        "...............",
        "...............",
        "......#######..",
        "####..###..##..",
        "#########..####",
        "#S##.......##G#",
        "####.......####",
        "............###",
        "...............",
        "..............."
    ]
}