{
    "name": "Stage 03",
    "grid": [
        ".....######....",
        ".....#..###....",
        ".....#..#####..",
        "S#####.....####",
        "....###....##G#",
        "....###.....###",
        "......#..##....",
        "......#####....",
        "......#####....",
        ".......###....."
    ]
}