{
    "name": "Stage 04",
    "grid": [
        "...............",
        "...FFFFFFF.....",
        "...FFFFFFF.....",
        "####.....###...",
        "###.......##...",
        "###.......##...",
        "#S#..####FFFFF.",
        "###..####FFFFF.",
        ".....#G#..FF#F.",
        ".....###..FFFF."
    ]
}