{
    "name": "Stage 01",
    "grid": [
        "...............",
        "...............",
        "..###..........",
        "..#S####.......",
        "..#########....",
        "...#########...",
        ".......##G##...",
        "........###....",
        "...............",
        "..............."
    ]
}